스물하나	스물 하나
스물다섯	스물 다섯
스물여섯	스물 여섯
스물일곱	스물 일곱
스물여덟	스물 여덟
스물아홉	스물 아홉
서른하나	서른 하나
서른다섯	서른 다섯
서른여섯	서른 여섯
서른일곱	서른 일곱
서른여덟	서른 여덟
서른아홉	서른 아홉
마흔하나	마흔 하나
마흔다섯	마흔 다섯
마흔여섯	마흔 여섯
마흔일곱	마흔 일곱
마흔여덟	마흔 여덟
마흔아홉	마흔 아홉
예순하나	예순 하나
예순다섯	예순 다섯
예순여섯	예순 여섯
예순일곱	예순 일곱
예순여덟	예순 여덟
예순아홉	예순 아홉
일흔하나	일흔 하나
일흔다섯	일흔 다섯
일흔여섯	일흔 여섯
일흔일곱	일흔 일곱
일흔여덟	일흔 여덟
일흔아홉	일흔 아홉
여든하나	여든 하나
여든다섯	여든 다섯
여든여섯	여든 여섯
여든일곱	여든 일곱
여든여덟	여든 여덟
여든아홉	여든 아홉
아흔하나	아흔 하나
아흔다섯	아흔 다섯
아흔여섯	아흔 여섯
아흔일곱	아흔 일곱
아흔여덟	아흔 여덟
아흔아홉	아흔 아홉
이십일	이십 일
이십이	이십 이
이십삼	이십 삼
이십사	이십 사
이십오	이십 오
이십육	이십 육
이십칠	이십 칠
이십팔	이십 팔
이십구	이십 구
삼십일	삼십 일
삼십이	삼십 이
삼십삼	삼십 삼
삼십사	삼십 사
삼십오	삼십 오
삼십육	삼십 육
삼십칠	삼십 칠
삼십팔	삼십 팔
삼십구	삼십 구
사십일	사십 일
사십이	사십 이
사십삼	사십 삼
사십사	사십 사
사십오	사십 오
사십육	사십 육
사십칠	사십 칠
사십팔	사십 팔
사십구	사십 구
오십일	오십 일
오십이	오십 이
오십삼	오십 삼
오십사	오십 사
오십오	오십 오
오십육	오십 육
오십칠	오십 칠
오십팔	오십 팔
오십구	오십 구
육십일	육십 일
육십이	육십 이
육십삼	육십 삼
육십사	육십 사
육십오	육십 오
육십육	육십 육
육십칠	육십 칠
육십팔	육십 팔
육십구	육십 구
칠십일	칠십 일
칠십이	칠십 이
칠십삼	칠십 삼
칠십사	칠십 사
칠십오	칠십 오
칠십육	칠십 육
칠십칠	칠십 칠
칠십팔	칠십 팔
칠십구	칠십 구
팔십일	팔십 일
팔십이	팔십 이
팔십삼	팔십 삼
팔십사	팔십 사
팔십오	팔십 오
팔십육	팔십 육
팔십칠	팔십 칠
팔십팔	팔십 팔
팔십구	팔십 구
구십일	구십 일
구십이	구십 이
구십삼	구십 삼
구십사	구십 사
구십오	구십 오
구십육	구십 육
구십칠	구십 칠
구십팔	구십 팔
구십구	구십 구
열하나	열 하나
열다섯	열 다섯
열여섯	열 여섯
열일곱	열 일곱
열여덟	열 여덟
열아홉	열 아홉
스물둘	스물 둘
스물셋	스물 셋
스물넷	스물 넷
서른둘	서른 둘
서른셋	서른 셋
서른넷	서른 넷
마흔둘	마흔 둘
마흔셋	마흔 셋
마흔넷	마흔 넷
쉰하나	쉰 하나
쉰다섯	쉰 다섯
쉰여섯	쉰 여섯
쉰일곱	쉰 일곱
쉰여덟	쉰 여덟
쉰아홉	쉰 아홉
예순둘	예순 둘
예순셋	예순 셋
예순넷	예순 넷
일흔둘	일흔 둘
일흔셋	일흔 셋
일흔넷	일흔 넷
여든둘	여든 둘
여든셋	여든 셋
여든넷	여든 넷
아흔둘	아흔 둘
아흔셋	아흔 셋
아흔넷	아흔 넷
이십한	이십 한
스물한	스물 한
삼십한	삼십 한
서른한	서른 한
사십한	사십 한
마흔한	마흔 한
오십한	오십 한
육십한	육십 한
예순한	예순 한
칠십한	칠십 한
일흔한	일흔 한
팔십한	팔십 한
여든한	여든 한
구십한	구십 한
아흔한	아흔 한
스물두	스물 두
스물세	스물 세
스물네	스물 네
서른두	서른 두
서른세	서른 세
서른네	서른 네
마흔두	마흔 두
마흔세	마흔 세
마흔네	마흔 네
예순두	예순 두
예순세	예순 세
예순네	예순 네
일흔두	일흔 두
일흔세	일흔 세
일흔네	일흔 네
여든두	여든 두
여든세	여든 세
여든네	여든 네
아흔두	아흔 두
아흔세	아흔 세
아흔네	아흔 네
쉰한	쉰 한
십일	십 일
십이	십 이
십삼	십 삼
십사	십 사
십오	십 오
십육	십 육
십칠	십 칠
십팔	십 팔
십구	십 구
열둘	열 둘
열셋	열 셋
열넷	열 넷
쉰둘	쉰 둘
쉰셋	쉰 셋
쉰넷	쉰 넷
열두	열 두
열세	열 세
열네	열 네
쉰두	쉰 두
쉰세	쉰 세
쉰네	쉰 네
